Gg, Gg, Gg, Gg, Gg, Gg, Gg, Gg, Gg, Gg, Gg, Gg, Gg, Gg, Gg, Gg, Gg, Gg, Gg, Gg, Gg, Gg, Gg, Gg, Gg, Gg, Gg, Gg, Gg, Gg, Gg, Gg
Gg, Ce, Ce, Ce, Ce, Ce, Ce, Ce, Ce, Ce, Ce, Ce, Ce, Ce, Ce, Ce, Ce, Ce, Ce, Ce, Ce, Ce, Ce, Ce, Ce, Ce, Ce, Ce, Ce, Ce, Gg, Gg
Gg, Ce, Ce, Ce, Ce, Ce, Ce, Ce, Ce, Ce, Ce, Ce, Ce, Ce, Ce, Ce, Ce, Ce, Ce, Ce, Ce, Ce, Ce, Ce, Ce, Ce, Ce, Ce, Ce, Ce, Gg, Gg
Gg, Ce, Ce, Ce, Ce, Ce, Ce, Ce, Ce, Ce, Ce, Ce, Ce, Ce, Ce, Ce, Ce, Ce, Ce, Ce, Ce, Ce, Ce, Ce, Ce, Ce, Ce, Ce, Ce, Ce, Gg, Gg
Gg, Ce, Ce, Ce, Ce, Ce, Ce, Ce, Ce, Ce, Ce, Ce, Ce, Ce, Ce, Ce, Ce, Ce, Ce, Ce, Ce, Ce, Ce, Ce, Ce, Ce, Ce, Ce, Ce, Ce, Gg, Gg
Gg, Ce, Ce, Ce, Ce, Ce, Ce, Ce, Ce, Ce, Ce, Ce, Ce, Ce, Ce, Ce, Ce, Ce, Ce, Ce, Ce, Ce, Ce, Ce, Ce, Ce, Ce, Ce, Ce, Ce, Gg, Gg
Gg, Ce, Ce, Ce, Ce, Ce, Ce, Ce, Ce, Ce, Ce, Ce, Ce, Ce, Ce, Ce, Ce, Ce, Ce, Ce, Ce, Ce, Ce, Ce, Ce, Ce, Ce, Ce, Ce, Ce, Gg, Gg
Gg, Ce, Ce, Ce, Ce, Ce, Ce, Ce, Ce, Ce, Ce, Ce, Ce, Ce, Ce, Ce, Ce, Ce, Ce, Ce, Ce, Ce, Ce, Ce, Ce, Ce, Ce, Ce, Ce, Ce, Gg, Gg
Gg, Ce, Ce, Ce, Ce, Ce, Ce, Ce, Ce, Ce, Ce, Ce, Ce, Ce, Ce, Ce, Ce, Ce, Ce, Ce, Ce, Ce, Ce, Ce, Ce, Ce, Ce, Ce, Ce, Ce, Gg, Gg
Gg, Ce, Ce, Ce, Ce, Ce, Ce, Ce, Ce, Ce, Ce, Ce, Ce, Ce, Ce, Ce, Ce, Ce, Ce, Ce, Ce, Ce, Ce, Ce, Ce, Ce, Ce, Ce, Ce, Ce, Gg, Gg
Gg, Ce, Ce, Ce, Ce, Ce, Ce, Ce, Ce, Ce, Ce, Ce, Ce, Ce, Ce, Ce, Ce, Ce, Ce, Ce, Ce, Ce, Ce, Ce, Ce, Ce, Ce, Ce, Ce, Ce, Gg, Gg
Gg, Ce, Ce, Ce, Ce, Ce, Ce, Ce, Ce, Ce, Ce, Ce, Ce, Ce, Ce, Ce, Ce, Ce, Ce, Ce, Ce, Ce, Ce, Ce, Ce, Ce, Ce, Ce, Ce, Ce, 1 Gg^Kov, Gg
Gg, Ce, Ce, Ce, Ce, Ce, Ce, Ce, Ce, Ce, Ce, Ce, Ce, Ce, Ce, Ce, Ce, Ce, Ce, Ce, Ce, Ce, Ce, Ce, Ce, Ce, Ce, Ce, Ce, Ce, 2 Gg^Kov, Gg
Gg, Ce, Ce, Ce, Ce, Ce, Ce, Ce, Ce, Ce, Ce, Ce, Ce, Ce, Ce, Ce, Ce, Ce, Ce, Ce, Ce, Ce, Ce, Ce, Ce, Ce, Ce, Ce, Ce, Ce, Gg, Gg
Gg, Gg, Gg, Gg, Gg, Gg, Gg, Gg, Gg, Gg, Gg, Gg, Gg, Gg, Gg, Gg, Gg, Gg, Gg, Gg, Gg, Gg, Gg, Gg, Gg, Gg, Gg, Gg, Gg, Gg, Gg, Gg
